################
#..............#
#..............#
#..............#
#....#......##.#
#..............#
#..............#
#..#...........#
#..#...........#
#..............#
#..............#
#.....##.......#
#.....#######..#
#..............#
#..............#
################